********************
*P                 *
*                  *
*                  *
*                  *
*        M         *
*                  *
*                  *
*                 G*
********************